########################################
#.........................#...........%#
#.........................#............#
#.........................#............#
#.........................#............#
#.........................#............#
#.........................######.#######
#......................................#
#......................................#
#......................................#
#..........#############################
#..........#...........................#
#..........#...........................#
#......................................#
#..........#...........................#
########################################