################################################
#..............................................#
#..............................................#
#..............................................#
#..............................................#
#..............................................#
#..............................................#
#..............................................#
#...................................############
#...................................#..........#
#..............................................#
#...................................#..........#
################################################